SUB	GE	S/P	FP/SP/TP
ನಾನು	G	S	F
ನಾನೂ	G	S	F	
ನಾವು	G	P	F
ನಾವೂ	G	P	F
ನೀನು	G	S	S 
ನೀವು	G	P	S 
ಅವನು	M	S	T	 
ಇವನು	M	S	T 
ಅವಳು	F	S	T 
ಇವಳು	F	S	T 
ಅವರು	G	P	T 
ಇವರು	G	P	T 
ಅದು	N	S	T 
ಅವು		N	P	T	
ಇದು	N	S	T 
ಇವು		N	P	T
ಹುಡುಗ	M	S	T
ಹುಡುಗರು	M	P	T 
ಅಜ್ಜ	M	S	T
ಅಜ್ಜಂದಿರು	M	P	T 
ಅಪ್ಪ	M	S	T 
ಅಪ್ಪಂದಿರು	M	P	T	 
ಶಿಕ್ಷಕ	M	S	T 
ಶಿಕ್ಷಕರು	M	P	T 
ಕವಿ    M	S	T
ಕವಿಗಳು 	M	P	T
ಅಧ್ಯಾಪಕ	M	S 	T 
ಅಧ್ಯಾಪಕರು    M    P	T 
ವೈದ್ಯ	M	S	T
ವೈದ್ಯರು	M	P	T
ನೌಕರ	M	S	T 
ನೌಕರರು	M	P	T 
ಅಣ್ಣ	M	S	T 
ಅಣ್ಣಂದಿರು	M	P	T 
ತಮ್ಮ	M	S	T 
ತಮ್ಮಂದಿರು	M	P	T 
ಚಿಕ್ಕಪ್ಪ	M	S	T 
ಚಿಕ್ಕಪ್ಪಂದಿರು	M	P	T 
ದೊಡ್ಡಪ್ಪ	M	S	T 
ದೊಡ್ಡಪ್ಪಂದಿರು	M	P	T 
ಬಾಲಕ	M	S	T 
ಬಾಲಕರು		M	P	T	
ಚಾಲಕ	M	S	T 
ಚಾಲಕರು		M	P	T 
ಹುಡುಗಿ	F	S	T 
ಹುಡುಗಿಯರು	F	P	T 
ಅಜ್ಜಿ	F	S	T 
ಅಜ್ಜಿಯಂದಿರು		F	P	T
ಅಮ್ಮ	F	S	T 
ಅಮ್ಮಂದಿರು	F	P	T 
ಕವಯಿತ್ರಿ		F	S	T 
ಕವಯಿತ್ರಿಯರು	F	P	T 
ಶಿಕ್ಷಕಿ	F	S	T 
ಶಿಕ್ಷಕಿಯರು 	F	P	T
ಅಧ್ಯಾಪಕಿ	F	S	T 
ಅಧ್ಯಾಪಕಿಯರು	F	P	T 
ವೈದ್ಯೆ	F	S	T 
ವೈದ್ಯೆಯರು	F	P	T 
ಅಕ್ಕ		F	S	T 
ಅಕ್ಕಂದಿರು	F	P	T 
ತಂಗಿ		F	S	T 
ತಂಗಿಯರು	F	P	T 
ಚಿಕ್ಕಮ್ಮ	F	S	T 
ಚಿಕ್ಕಮ್ಮಂದಿರು		F	P	T 
ದೊಡ್ಡಮ್ಮ	F	S	T 
ದೊಡ್ಡಮ್ಮಂದಿರು	F	P	T 
ಬಾಲಕಿ	F	S	T 
ಬಾಲಕಿಯರು	F	P	T 
ಚಾಲಕಿ 	F	S	T
ಚಾಲಕಿಯರು	F	P	T 
ಹಣ್ಣು	N	S	T 
ಹಣ್ಣುಗಳು	N	P	T 
ಜನರು	G	P	T 
ವ್ಯಕ್ತಿ		G	S	T 
ವ್ಯಕ್ತಿಗಳು	G	P	T	 
ಮನುಷ್ಯ	G	S	T 
ಮನುಷ್ಯರು	G	P	T 
ಪರ್ವತ	N	S	T 
ಪರ್ವತಗಳು	N	P	T 
ನದಿ	N	S	T 
ನದಿಗಳು	N	P	T 
ಕೆರೆ	N	S	T 
ಕೆರೆಗಳು	N	P	T 
ಕಾಡು	N	S	T 
ಕಾಡುಗಳು	N	P	T 
ಅರಣ್ಯ	N	S	T 
ಅರಣ್ಯಗಳು	N	P	T 
ವೃಕ್ಷ		N	S	T 
ವೃಕ್ಷಗಳು	N	P	T 
ಬೆಟ್ಟ	N	S	T 
ಬೆಟ್ಟಗಳು	N	P	T 
ಬಣ್ಣ	N	S	T 
ಬಣ್ಣಗಳು	N	P	T 
ಕಲ್ಲು	N	S	T 
ಕಲ್ಲುಗಳು	N	P	T 
ಮಣ್ಣು	N	S	T	 
ಮಣ್ಣುಗಳು	N	P	T 
ಮರ		N	S	T 
ಮರಗಳು	N	P	T 
ಗಿಡ	N	S	T	 
ಗಿಡಗಳು	N	P	T 
ಚಿನ್ನ	N	S	T 
ಬೆಳ್ಳಿ		N	S	T 
ನೀರು	N	S	T 
ಕಬ್ಬಿಣ	N	S	T 
ಗಾಳಿ		N	S	T 
ಬೆಳಕು	N	S	T 
ವಿದ್ಯಾರ್ಥಿ	M	S	T 
ವಿದ್ಯಾರ್ಥಿಗಳು		M	P	T 
ವಿದ್ಯಾರ್ಥಿನಿ	F	S	T 
ವಿದ್ಯಾರ್ಥಿನಿಯರು	F	P	T 
ರೋಗಿ	G	S	T 
ರೋಗಿಗಳು	G	P	T 
ರಾಜ		M	S	T 
ರಾಜರು	M	P	T 
ರಾಣಿ	F	S	T 
ರಾಣಿಯರು	F	P	T 
ಉದ್ಯಾನ	N	S	T 
ಉದ್ಯಾನಗಳು	N	P	T 
ಮಂತ್ರಿ	M	S	T 
ಮಂತ್ರಿಗಳು	M	P	T 
ದೇವಿ	F	S	T 
ದೇವಿಯರು	F	P	T 
ದೇವ	M	S	T
ದೇವರು	M	P	T
ಕುರುಡ	M	S	T 
ಕುರುಡರು		M	P	T	 
ಕುಂಟ	M	S	T
ಕುಂಟರು	M	P	T
ಅಂಧ	M	S	T 
ಅಂಧರು	M	P	T 
ಕಿವುಡ	M	S	T
ಕಿವುಡರು	M	P	T 
ಮೂಕ	M	S	T
ಮೂಕರು	M	P	T
ಬಳೆಗಾರ	M	S	T 
ಬಾಳೆಗಾರರು	M	P	T
ಮುದ್ರಕ	M	S	T 
ಮುದ್ರಕರು	M	P	T 
ಪ್ರಕಾಶಕ	M	S	T 
ಪ್ರಕಾಶಕರು	M	P	T 
ಸಂಪಾದಕ	M	S	T 
ಸಂಪಾದಕರು	M	P	T 
ಛಾಯಾಗ್ರಾಹಕ	M	S	T 
ಛಾಯಾಗ್ರಾಹಕರು	M	P	T 
ವ್ಯಾಪಾರಿ	M	S	T 
ವ್ಯಾಪಾರಿಗಳು	M	P	T 
ನರ್ತಕ	M	S	T 
ನರ್ತಕರು	M	P	T 
ನರ್ತಕಿ	F	S	T
ನರ್ತಕಿಯರು	F	P	T
ಹಾವಾಡಿಗ	M	S	T
ಹಾವಾಡಿಗರು	M	P	T
ಯುವಕ	M	S	T
ಯುವಕರು	M	P	T
ಯುವತಿ	F	S	T
ಯುವತಿಯರು	F	P	T
ಅತ್ತೆ	F	S	T 
ಅತ್ತೆಯರು	F	P	T
ಮಾವ	M	S	T
ಮಾವಂದಿರು	M	P	T
ನಾಯಿ	N	S	T
ನಾಯಿಗಳು	N	P	T
ಬೆಕ್ಕು	N	S	T
ಬೆಕ್ಕುಗಳು	N	P	T
ಸಿಂಹ	N	S	T
ಸಿಂಹಗಳು	N	P	T 
ಹುಲಿ	N	S	T 
ಹುಲಿಗಳು	N	P	T 
ಹಣ್ಣು	N	S	T 
ಹಣ್ಣುಗಳು	N	P	T 
